Level: boxworld-95

  #########     
  #    #  #     
### #$  $ ####  
#  $  ##..#  ###
# #  $ #..$ $  #
# $$  $#..  #  #
##  #  ...#$   #
 #$  @#...# $  #
 #    #...$   ##
 # ##$ ###   ## 
 #   $     ###  
 #  ########    
 ####           

