Level: boxworld-54

       ####    
  ######  #####
  #    $  ....#
###   # # ..#.#
# $$ #  # ....#
#    # $# ..#.#
##$###$ ####  #
 #  #  $ $    #
 #    $ $  #$ #
 # $## $ ##  ##
 ## #### # @## 
  #   #  $ ##  
  ###     ##   
    #######    

