Level: boxworld-72

###############
###.#      ####
##..# $  $ ####
#...# ## $ #  #
#.....  #$$   #
##....$    #$ #
#### #######  #
#   $        ##
#  $ #  $# $ ##
# $### $ # $$ #
#   @#  ##    #
###############

