Level: boxworld-51

#######  
#  .$ ###
# .$.$  #
#*$.$.@ #
# .$.$ ##
#  .$  # 
######## 

