Level: boxworld-65

##########
##       #
#   #$#$ #
# $$  .$.#
# @###...#
##########

