Level: boxworld-70

   #########
   #   #   #
   #       #
#####*### ##
#   ...   # 
# # #*###$##
# $    $   #
#####@ #   #
    ########

