Level: boxworld-42

##### #######
#   ###  #  #
# $     $ @ #
## #$##.##  #
 #  ...*. $ #
 # $# #.# # #
 ##    $    #
  #  ########
  ####       

