Level: boxworld-64

############
#    ... $ #
# $$$*** $@#
#    ... $ #
############

