Level: boxworld-38

############
#... #     #
#..  # ##  #
#..  #  #  #
#..    $## #
#... #$ $  #
######  $$ #
 ##  $ $$  #
 #@ $$$  # #
 ## $ ##   #
  #        #
  ##########

