Level: boxworld-94

#######
#  *  #
# @.$ #
# $.  #
#*.***#
#  *  #
# $*$ #
#  .  #
#######

