Level: boxworld-12

  ##### 
###  @# 
#  $. ##
#  .$. #
### *$ #
  #   ##
  ##### 

