Level: boxworld-9

 ######### 
 #  ##   # 
 #   $   # 
 #$ ### $# 
 # #...# # 
## #...# ##
# $  $  $ #
#     # @ #
###########

