Level: boxworld-18

  ########
  #   #. #
 ##  $...#
 #  $ #*.#
## ##$# ##
#   $  $ #
#   #    #
#######@ #
      ####

