Level: boxworld-88

 ####  ######
 #  ####    #
##*   * **  #
# $ *    *# #
# .   ###   #
######   #@##
# * . *  ** #
#   #   #   #
##*   * #$# #
 #  #####   #
 ####   #####

