Level: boxworld-48

   #####   
   # @ #   
   # $ #   
   #$.$#   
 ###.$.##  
## .$.$.###
#  $.$.$  #
#    .    #
###########

