Level: boxworld-78

 #####     
 # @ ######
 # #..*   #
 # ...#   #
##$## $ $ #
#   #$#####
#   $   #  
##### # #  
    #   #  
    #####  

