Level: boxworld-60

####      ####
#..########..#
#*.*.....*.*.#
# $ $ $ $ $ $#
#$ $ $@$ $ $ #
# $ $ $ $ $ $#
#$ $ $ $ $ $ #
#.*.*.....*.*#
#..########..#
####      ####

