Level: boxworld-93

    #####      
#####   #      
#   $ @ #      
#  $ #.#####   
##$ ##.##  ####
 #  ..... $#  #
 # $##.##   $ #
 #   #.##     #
 ### $ ##### ##
   # #$     $ #
   #    ###   #
   ###### #####

