Level: boxworld-101

 #####  
 #  @###
## #$  #
# *. . #
#  $$ ##
### #.# 
  #   # 
  ##### 

