Level: boxworld-34

###############
#      #      #
# $ #$ # $##$ #
# #  $ #  @   #
#   ##$#$##$$ #
# # # ... #   #
# $  . # .$ # #
# $# $...# #  #
#    . # .  $ #
# ##.$###$. # #
# # $..... ## #
#             #
###############

