Level: boxworld-53

      ####   
#######  ####
#@$    $  $ #
#$### $ # # #
#  #  # $   #
# $#    # ###
#  $ #$#   # 
#......... # 
########   # 
       ##### 

