Level: boxworld-37

   ##### 
   # @ # 
   #$$$# 
####   # 
#   .#$##
# $.$. .#
#  #.#.##
######## 

