Level: boxworld-35

#########
#   ##  #
# # $ $ #
#  *.#  #
## #.@.##
##$###*##
#       #
#   # # #
#####   #
    #####

