Level: boxworld-45

      ####     
      #  ######
      #    #  #
      # $$    #
#######$#  #  #
#  #. .. ###$##
#  #.#*.$     #
#  #.#.*# #   #
# $$....# #####
# @$ # ## #    
# $$$#    #    
#    ######    
######         

