Level: boxworld-49

#############
#  $ $ $.*..#
# $ $ $ *...#
#  $ $ $.*..#
# $ $ $ *...#
#  $ $ $.*..#
# $ $ $ *...#
#  $ $ $.*..#
# $ $ $ *...#
#  $ $ $.*..#
#@$ $ $ *...#
#############

