Level: boxworld-67

##########      
#...###  ####   
#...###  $  #   
#....## $  $### 
##....##   $  # 
###... ## $ $ # 
# ##    #  $  # 
#  ## # ### ####
# $ # #$  $    #
#  $ @ $    $  #
#   # $ $$ $ ###
#  ######  ###  
# ##    ####    
###             

