Level: boxworld-74

       #####
  ######   #
###    . $ #
# $  #$.#$##
#  #  @.#  #
#  ####.   #
## $  #*####
 # ## #.  # 
 #     .# # 
 ###$     # 
   #  ##### 
   ####     

