Level: boxworld-71

#####           
#...# #####     
#...###   #     
#....   $$##### 
#....  #  #   ##
#..#$#### #$#  #
## $  #     $$ #
#  $# @ $ $$#  #
# $ $ $ #   $ ##
#      $ ##   # 
######   ###### 
     #####      

