Level: boxworld-43

         ###   
    ######@##  
    #....#$ ## 
    #....# $ # 
    #.... $  # 
    # ...#   # 
###### ##### ##
# $ $   $  #  #
#    $$   $ $ #
### $ $ $  ####
  ##   $ $ #   
   #  ######   
   ####        

