Level: boxworld-36

########       
#      #       
# $$   ###     
#  $ $$$ ##### 
## ## ...    ##
 # #@#...###$ #
 # # $...     #
## # $...$ # ##
#  ##### ### # 
#      $   $ # 
###########  # 
          #### 

