Level: boxworld-29

######## 
#......# 
#  $ # ##
##$ # $ #
 #$ $ $ #
 #  @   #
 ########

