Level: boxworld-92

  #####     
  #   ######
###$#.     #
# $ ...# $ #
#@ $.#*$   #
####    ####
   ######   

