Level: boxworld-103

########
#.     #
# ## # #
# *@*  #
##$$.###
 #    # 
 #.$  # 
 ###### 

