Level: boxworld-87

      #####     
#######   #     
#   ##.   #     
#  $#..  ###    
##  ...#$$ #####
 # $.#.$       #
 # $###$## # $ #
 #   #     $$# #
 ##$$# ##$#$   #
 #... $@ $   ###
 #...#$#   ###  
 #...  #####    
 #######        

