Level: boxworld-86

####     ####   
#  #######..### 
# $ $ $  #....# 
# $   $$ #***.# 
# $ $ $  #..*.# 
#  $ $ $ #*.*.# 
## $ $ $ .*.*.##
#  $ $ $ .*.*.@#
#  $ $ $ #*.*.##
# $ $ $  #..*.# 
# $   $$ #***.# 
# $ $ $  #....# 
#  #######..### 
####     ####   

