Level: boxworld-61

    #####   
   ##   ####
   # ..* $ #
#### #.#   #
#    .*.#@##
# #$##$## # 
#     $ $ # 
##  #   ### 
 ########   

