Level: boxworld-76

   ########
####    . #
#  $ $ $. #
#  .####.##
# $.$ $ @# 
#  .  #### 
#######    

