Level: boxworld-57

##############
#.           #
#.$ $ $ $ $  #
#.#########  #
#.#.* $ ..$*##
#.# $ $ *.$@# 
#.#.  $ ..$$# 
#.#########.# 
#.          # 
#.#$#$#$#$#$# 
#.          # 
############# 

