Level: boxworld-28

    ####        
#####  #        
#  $ $ # #######
#   $  # #*.*.*#
## $ $ ###.*.*.#
 #$ $  #  *.*.*#
 #@$ $    .*.*##
 #$ $  #  *.*.*#
## $ $ ###.*.*.#
#   $  # #*.*.*#
#  $ $ # #######
#####  #        
    ####        

