Level: boxworld-82

       #       
     #####     
   ### @ ###   
   #  $ $  #   
   # *.*.* #   
   # .$ $. #   
   # *.*.* #   
  ##  $ $  ##  
 ########  ### 
###############
    ##   ##    

