Level: boxworld-66

 ####     
 #  ##### 
##$ ##  # 
#  $@$  # 
#   ##$ ##
###.## ###
 #...$ $ #
 ##..    #
  ########

