Level: boxworld-77

  #####    
  #   #    
###$.$#####
#   . $   #
# ##$## @ #
#   . #####
### . #    
  #   #    
  #####    

