Level: boxworld-84

 ############# 
 #    #  ##  # 
 #$$$ # $$  $##
 # $  #  .... #
 #  $  #$.##. #
 #  # $# ....##
##$ $  #$.##. #
# $  $ @$.... #
#   ###  ######
##### ####     

