Level: boxworld-31

  #######
### .  @#
#  $$$  #
#.##.##.#
#   $   #
#  $.#  #
####   ##
   ##### 

