Level: boxworld-55

###########
#    #    #
# $@$$$$$ #
#         #
##### #####
   #.  #   
   #.  #   
   #...#   
   #.  #   
   #####   

