Level: boxworld-80

     ####### 
     #  #  # 
     #  $$ # 
###### $#  # 
#...### #  ##
#.  #  $ #  #
#.    $ $ $ #
#.  #  $ #  #
#...### #  ##
###### $   # 
     #@ #  # 
     ####### 

