Level: boxworld-90

   #######     
   #     #     
   # $ $ ##    
   #####..#####
######..*.  $ #
#  $@$....#$$ #
#   $ #$###   #
#####       ###
    ###  ####  
      #  #     
      ####     

