Level: boxworld-47

#######    
# @#  #####
# $$  $   #
#  #.##$# #
##$#...   #
## ...##$##
#  ##.##  #
#  $  $   #
#  #   #  #
###########

