Level: boxworld-25

     ######
 #####.   #
 #  #..## #
 #  $..   #
 #  # .# ##
### ##$#  #
# $    $$ #
# #$#  #  #
#@  #######
#####      

