Level: boxworld-7

   #######
  ##  # @#
  #   #  #
  #$ $ $ #
  # $##  #
### $ # ##
#.....  # 
######### 

