Level: boxworld-63

  ###### 
### .  ##
# $.$.  #
#@$# #$ #
# $. .  #
####$#$ #
  #. .  #
  #######

