Level: boxworld-75

    ####    
#####  #####
#    $   $ #
#  $#$##   #
### #.*. ###
  # ... @#  
  ## #$###  
   #   #    
   #####    

