Level: boxworld-98

 ##### ###### 
 #   ###    # 
## $ $ #$ #$# 
#  $ @ $  $ ##
# #  ## #....#
#  ## $ #.##.#
##  $    ....#
 # $$ #$#....#
 #   #   #$ ##
 ##### $    # 
     ####  ## 
        ####  

