Level: boxworld-15

 ###### 
##    ##
# $ $$ #
#......#
# $$ $ #
### @###
  ####  

