Level: boxworld-69

      #### 
#######  # 
#     $  # 
#   $##@$# 
##$#...# # 
 # $...  # 
 # #. .# ##
 #   # #$ #
 #$  $    #
 #  #######
 ####      

