Level: boxworld-62

######   
#    #   
# $  ####
# $*..* #
# *..*$ #
####  $ #
   # @  #
   ######

