Level: boxworld-79

     ######   
   ###    ##  
   #   ##  #  
 ###$##  # #  
##     ..# #  
#  $#$#*.# #  
# $$@ #.*# ###
#  $$ #..#   #
##    #..$   #
 ###$##. # ###
   #  ###  #  
   ##     ##  
    #######   

